NO ./Textures/north_wall.xpm
SO ./Textures/south_wall.xpm
WE ./Textures/west_wall.xpm
EA ./Textures/east_wall.xpm

C 135,206,235
F 125,200,10

1111111111111111111111111111111111111111
10000000000000000010000000000000000000001
10000000000000000010000000000000000000001
10000000000000000010000000000000000000001
10000000000000000010000000000000000000001  1
11111111111111111110000000000000000000000111
10000000000000000011000000000000111110000001
10000000000000000000000000000000100010000001
10000000000000000000001110000000100010000001
1000000000S000000000000000000000100010000001
10100000000000000000000000000000111110000001
10000000000000000000000000000000000000000001
10000000000000000000000000000000000000000001
11111111111111111111111111111111111111111111
