NO ./Textures/north_wall.xpm
SO ./Textures/south_wall.xpm
WE ./Textures/west_wall.xpm
EA ./Textures/east_wall.xpm

F 191, 160, 116
C 229, 227, 196

                                   111111111111
                                   100000000001
                                   100000000001
                                   1000S0000001
                                   100000000001
                                   100000000001 11111111111
                                   100000000001 10000000001
                                   100000000001110000000001
                                   1000000000000D0000000001
                                   100000000001110000000001
                                   100000000001 10000000001
                                   111111111111 10000000001
                                                11111001111
                         111111111                  100011
           11111111111111100000001                  1100011
           10000000000010000000001                   110001
           10000000000011100000001                    110011111111
           100000000000D0000000001                     10000000001
           10000000000011100000001     111111111111111110000000001
           10000000000011100000111  111100000000D00000000000000001
           1000000000001 1000000011 100100000000110000000000000001
           1000000000001 11111110011100100000000110011110000000001
           1111000011111       1100000000000000011111  11111111111
              100001            11100001000000001
              111001              100111000000001
                1001              1111 1111111111
                1001
                10011
                10001
               110001111
               100000001
               111100001
                  111111
