NO ./Textures/north_wall.xpm
SO ./Textures/south_wall.xpm
WE ./Textures/west_wall.xpm
EA ./Textures/east_wall.xpm
F 250,200,10
C 140,125,10

11111111
10000001
10010001
10010101
101F0001
11111111
